wholesale	広範囲に及ぶ	extensiveと同義http://www.dictionary.com/browse/wholesale
wholesale	大規模な
greasing the skids	ことを速やかに［順調に］運ぶ	grease the skids
unconference	コメント参照	[*]https://en.oxforddictionaries.com/definition/unconference
>A loosely structured conference emphasizing the informal exchange of information and ideas between participants, rather than following a conventionally structured programme of events.
women's organizations	女性による団体、または、女性のための団体
tally	集計する
move the needle	目立った変化をもたらす、〔地震計などの〕針を動かす
gave them away	配る（景品などを）
in a minute	すぐに
part and parcel	本質的に重要な部分
sleeper 	コメント参照	((もと米話)) 思いがけなく成功する人［真価を発揮する人］；(映画・演劇・本などで)予想外に当たった［ヒットした］もの；(古本などの)掘り出し物；急に値の出たもの；〔競馬〕 穴馬，ダークホース. 
reconcile	《会計》〔残高を〕照合する
a flurry of 	立て続けの
executive order	〈米〉大統領（行政）命令
taking	 Ascertain by measurement or observation
sliver	コメント参照	    〔裂けたり切り取られたりした〕薄片、細い破片、とげ
    わずかな部分、ほんの一部
    〔羊毛などの〕スライバー◆羊毛などを糸にする過程でできる、繊維が平行に並んだひも状のもの。繊維は洗浄され、ほぐされてスライバーになり、コーマー（comber）によって不純物を除いてから紡ぎの工程に移る。
lather rinse repeat	To mindlessly repeat past patterns or behaviors without critical thought.	http://www.urbandictionary.com/define.php?term=lather%20rinse%20repeat
brownfield	使われなくなった産業設備	brownfield
